1111111111
1P000000C1
10000C0001
1000000001
1000001101
1C000C00E1
1000000001
1111111111